0  0  0  0  0  0  0  0  0  0  0  0  0  0  0  0  0  0  0
0  0  0  0  0  0  0  0  0  0  0  0  0  0  0  0  0  0  0
0  0 40 30  0  0 0 -10  0  0  0 30 30 30 30 30  0  0  0
0  0 30 20  0  0 -10 -20  0  0  0  0  0  0  0 30 30  0  0
0  0 20 10  0  0 -20 -30  0  0  0  0  0  0  0 30 30  0  0
0  0 10 00 -10 -20 -30 -40  0  0  0  0 30 30 30 30  0  0  0
0  0  0 -10 -20 -20 -40 -50  0  0  0 30 30  0  0  0  0  0  0
0  0  0  0  0  0 -30 -60  0  0  0 30 30  0  0  0  0  0  0
0  0  0  0  0  0 -40 -70  0  0  0 30 30 30 30 30 30  0  0
0  0  0  0  0  0  0  0  0  0  0  0  0  0  0  0  0  0  0
0  0  0  0  0  0  0  0  0  0  0  0  0  0  0  0  0  0  0