90 90 90 90 90 90 90 90 90 90 90 90 90 90 90 90 90 90 90 90 90 0  0  0  0  0  0  0  0  0  0  0  0  0  0  0  0  0  0  0  0  0  0  0  0  0  0  0  0  0  0 90 90 90 90 90 90 90 90 90 90 90 90 90 90 90 90 90 90 90 90 90 
0  0  84 84 84 84 84 84 84 84 84 84 84 84 84 84 84 84 84 84 84 84 0  0  0  0  0  0  0  0  0  0  0  84 0  0  0  0  84 0  0  0  0  0  0  0  0  0  0  0  84 84 84 84 84 84 84 84 84 84 84 84 84 84 84 84 84 84 84 84 0  0  
0  0  0  0  78 78 78 78 78 78 78 78 78 78 78 78 78 78 78 78 78 78 78 0  0  0  0  0  0  0  0  0  0  78 78 78 78 78 78 0  0  0  0  0  0  0  0  0  0  78 78 78 78 78 78 78 78 78 78 78 78 78 78 78 78 78 78 78 0  0  0  0  
0  0  0  0  0  72 72 72 72 72 72 72 72 72 72 72 72 72 72 72 72 72 72 72 0  0  0  0  0  0  0  0  72 72 72 72 72 72 72 72 0  0  0  0  0  0  0  0  72 72 72 72 72 72 72 72 72 72 72 72 72 72 72 72 72 72 72 0  0  0  0  0  
0  0  0  0  0  0  66 66 66 66 66 66 66 66 66 66 66 66 66 66 66 66 66 66 66 66 66 66 66 66 66 66 66 66 66 66 66 66 66 66 66 66 66 66 66 66 66 66 66 66 66 66 66 66 66 66 66 66 66 66 66 66 66 66 66 66 0  0  0  0  0  0  
0  0  0  0  0  0  60 60 60 60 60 60 60 60 60 60 60 60 60 60 60 60 60 60 60 60 60 60 60 60 60 60 60 60 60 60 60 60 60 60 60 60 60 60 60 60 60 60 60 60 60 60 60 60 60 60 60 60 60 60 60 60 60 60 60 60 0  0  0  0  0  0  
0  0  0  0  0  0  54 54 54 54 54 54 54 54 54 54 54 54 54 54 54 54 54 54 54 54 54 54 54 54 54 54 54 54 54 54 54 54 54 54 54 54 54 54 54 54 54 54 54 54 54 54 54 54 54 54 54 54 54 54 54 54 54 54 54 54 0  0  0  0  0  0  
0  0  0  0  0  0  48 48 48 48 48 48 48 48 48 48 48 48 48 48 48 48 48 48 48 48 48 48 48 48 48 48 48 48 48 48 48 48 48 48 48 48 48 48 48 48 48 48 48 48 48 48 48 48 48 48 48 48 48 48 48 48 48 48 48 48 0  0  0  0  0  0   
0  0  0  0  42 42 42 42 42 42 42 42 42 42 42 42 42 42 42 42 42 42 42 42 42 42 42 42 42 42 42 42 42 42 42 42 42 42 42 42 42 42 42 42 42 42 42 42 42 42 42 42 42 42 42 42 42 42 42 42 42 42 42 42 42 42 42 42 0  0  0  0  
0  0  0  0  0  0  0  0  0  0  0  0  0  0  0  0  0  0  0  0  36 36 36 36 36 36 36 36 36 36 36 36 36 36 36 36 36 36 36 36 36 36 36 36 36 36 36 36 36 36 36 36 0  0  0  0  0  0  0  0  0  0  0  0  0  0  0  0  0  0  0  0  
0  0  0  0  0  0  0  0  0  0  0  0  0  0  0  0  0  0  0  0  0  0  0  0  0  0  0  30 30 30 30 30 30 30 30 30 30 30 30 30 30 30 30 30 30 0  0  0  0  0  0  0  0  0  0  0  0  0  0  0  0  0  0  0  0  0  0  0  0  0  0  0  
0  0  0  0  0  0  0  0  0  0  0  0  0  0  0  0  0  0  0  0  0  0  0  0  0  0  0  0  0  0  0  24 24 24 24 24 24 24 24 24 24 0  0  0  0  0  0  0  0  0  0  0  0  0  0  0  0  0  0  0  0  0  0  0  0  0  0  0  0  0  0  0  
0  0  0  0  0  0  0  0  0  0  0  0  0  0  0  0  0  0  0  0  0  0  0  0  0  0  0  0  0  0  0  0  0  18 18 18 18 18 18 0  0  0  0  0  0  0  0  0  0  0  0  0  0  0  0  0  0  0  0  0  0  0  0  0  0  0  0  0  0  0  0  0  
0  0  0  0  0  0  0  0  0  0  0  0  0  0  0  0  0  0  0  0  0  0  0  0  0  0  0  0  0  0  0  0  0  0  12 12 12 12 0  0  0  0  0  0  0  0  0  0  0  0  0  0  0  0  0  0  0  0  0  0  0  0  0  0  0  0  0  0  0  0  0  0  
0  0  0  0  0  0  0  0  0  0  0  0  0  0  0  0  0  0  0  0  0  0  0  0  0  0  0  0  0  0  0  0  0  0  0 6 6  0  0  0  0  0  0  0  0  0  0  0  0  0  0  0  0  0  0  0  0  0  0  0  0  0  0  0  0  0  0  0  0  0  0  0  